


                                    O.
                                   ...
                                                   .
                              ^ M    ..        O**M.
                               ....           ......
             *               ^         *      ......
                         .....                ......
$          *   *       E      ^^   E     M  * ......
....................................................
